1111111111
1P0C101001
1000101001
1010001101
110100C001
1000011101
1001000101
11011111E1
11C1010101
1111111111