1111111111111111111111111111111111
1C1CCCC1CCCCCCCCC1CCCC1CCCC1CCCCC1
1CCCC1C111111CC1C1CCCC111C11CCCC11
1C1111C1CCCC1CC1C1CCCCCC1C1CCC1CC1
1CCCC1C1CCCC11CCC111C11CCC1CC11CC1
1C1111CCC1CCCCCCC1CCC1CCCC1111CCC1
1C1CCCC1C111111111CCC1CC1CCC1CCC11
1C111CC1CCCCCCCCP1CCC1C11CCC1C1CC1
1C1CCCC111111111C11C11C1CC111C1CC1
1C1C1CCCCCCCCCC1CC1C1CC1CC1CCC1111
1C111111CCC1CCC1CC1C1C11EC1CCCCCC1
1CCCCCC11111C1C1CCCC1CC1111111C1C1
1CCC1CC1CCC1C1C1C11111111CCCCCCCC1
11111CC11CC1C1C111CCCCCCCCC1CC1CC1
1CCCCCCCCCCCC1CCCCC11CCC1CC1CC1CC1
1111111111111111111111111111111111