11111111111111111111
1P010010100000C100E1
1001000000000CC11101
10010010101001000001
100000101C1001000001
10000C11111001010001
1111001C0000C1010001
10010010000001010001
100111100CC001010001
10000C10000001010001
10111110101111111111
1C0000000000000000C1
10001110000001110001
1C0000000C00000000C1
11111111111111111111